10 10
0 0 0 0 0 0 0 0 0 0
1 0 0 0 0 0 0 0 0 0
1 0 0 1 0 0 0 0 0 0
1 0 0 2 0 0 0 0 0 0
2 0 0 0 2 0 0 0 0 0
3 0 0 3 0 0 0 0 0 0
3 0 0 0 4 0 0 0 0 0
4 0 0 1 0 1 0 0 0 0
4 0 0 0 0 0 0 0 0 0
5 6 7 8 7 10 12 12 13 14